LAAAALAAAL
LBBBBLBBBL
LAAAALAAAL
LBBBBLBBBL
LAAAALAAAL
LAAAALAAAL
LAAAALAAAL
LBBBBLBBBL
LAAAALAAAL
LSSSSSSSSL